Address A,Port A,Address B,Port B,Packets,Bytes,Packets A ? B,Bytes A ? B,Packets B ? A,Bytes B ? A,Rel Start,Duration,Bits/s A ? B,Bits/s B ? A
192.168.0.20,20,192.168.1.30,1762,8,972,5,792,3,180,37.860808,0.397026,15958.65258,3626.966496
192.168.0.20,20,192.168.1.30,1767,8,668,5,488,3,180,40.276993,0.265448,14707.21196,5424.791296
192.168.0.20,20,192.168.1.30,1768,8,894,5,714,3,180,42.650261,1.689683,3380.515754,852.2308622
192.168.0.20,20,192.168.1.30,1770,13,7236,8,6936,5,300,45.556318,0.096963,572259.5217,24751.70941
192.168.0.20,20,192.168.1.30,1801,8,894,5,714,3,180,102.481712,0.540752,10563.06773,2662.958251
192.168.0.20,20,192.168.1.30,1802,59,58645,45,57805,14,840,104.493608,0.500405,924131.4535,13429.12241
192.168.0.20,20,192.168.1.30,1854,8,972,5,792,3,180,166.872656,0.547283,11577.19133,2631.179847
192.168.0.20,20,192.168.1.30,1856,8,733,5,553,3,180,169.853197,0.410844,10768.07742,3504.979992
192.168.0.20,20,192.168.1.30,1858,28,23085,20,22605,8,480,172.780773,0.172302,1049552.53,22286.45053
192.168.0.20,20,192.168.1.30,1860,30,24113,21,23573,9,540,174.184717,0.177345,1063373.65,24359.29967
192.168.0.20,20,192.168.1.30,1863,8,733,5,553,3,180,176.490871,0.335442,13188.56911,4292.843472
192.168.0.20,20,192.168.1.30,1893,8,972,5,792,3,180,240.204209,0.338636,18710.35566,4252.35356
192.168.0.20,20,192.168.1.30,1894,8,672,5,492,3,180,243.957139,0.343365,11463.0204,4193.787952
192.168.0.20,20,192.168.1.30,1895,8,1668,5,1488,3,180,245.455543,0.036651,324793.3208,39289.51461
192.168.0.20,1022,192.168.1.30,1021,7,420,4,240,3,180,280.914259,0.327374,5864.851821,4398.638866
192.168.0.20,33017,192.168.1.30,25,27,2506,11,1231,16,1275,303.843333,1.47001,6699.274155,6938.728308
192.168.0.20,20,192.168.1.30,1937,8,512,5,332,3,180,349.900366,0.39356,6748.653318,3658.908426
192.168.0.20,20,192.168.1.30,1938,13,7236,8,6936,5,300,351.452753,0.114169,486016.3442,21021.46817
192.168.0.20,20,192.168.1.30,1940,10,3657,6,3417,4,240,352.460696,0.060365,452845.1918,31806.5104
192.168.0.20,20,192.168.1.30,1942,22,16943,15,16523,7,420,353.892004,0.138581,953839.2709,24245.74797
192.168.0.20,20,192.168.1.30,1943,8,894,5,714,3,180,354.970674,0.320713,17810.31639,4489.995728
192.168.0.20,20,192.168.1.30,1987,8,972,5,792,3,180,442.163042,0.776838,8156.140663,1853.668332
192.168.0.20,20,192.168.1.30,1990,8,1377,4,240,4,1137,445.389518,0.080858,23745.33132,112493.5071
192.168.0.20,20,192.168.1.30,1992,8,797,5,617,3,180,446.916408,0.306826,16087.29378,4693.213743
192.168.0.40,43493,192.168.1.30,25,30,8155,15,6942,15,1213,35.615636,0.93652,59300.38867,10361.76483
192.168.0.40,43494,192.168.1.30,25,27,3567,12,2353,15,1214,37.413539,1.037536,18142.98492,9360.639053
192.168.0.40,43504,192.168.1.30,21,57,4354,31,2050,26,2304,68.0874,13.596116,1206.226837,1355.681284
192.168.0.40,43516,192.168.1.30,23,259,19377,158,9563,101,9814,91.891388,47.758841,1601.881419,1643.925991
192.168.0.40,43519,192.168.1.30,25,35,17287,20,16075,15,1212,98.679697,4.864876,26434.38394,1993.062105
192.168.0.40,43521,192.168.1.30,80,17,4691,9,834,8,3857,105.454424,2.338137,2853.553919,13196.83149
192.168.0.40,43522,192.168.1.30,80,36,25943,13,1077,23,24866,109.205124,1.563711,5509.969553,127215.323
192.168.0.40,43524,192.168.1.30,80,15,4571,7,714,8,3857,115.445558,2.132392,2678.681968,14470.13495
192.168.0.40,43525,192.168.1.30,80,40,26171,15,1185,25,24986,119.088307,1.521528,6230.578734,131373.1985
192.168.0.40,43526,192.168.1.30,80,28,15692,12,1022,16,14670,122.335959,2.823305,2895.89683,41568.30381
192.168.0.40,43527,192.168.1.30,80,12,1306,6,681,6,625,126.567406,3.02001,1803.967537,1655.623657
192.168.0.40,43528,192.168.1.30,80,12,1286,6,671,6,615,130.968139,1.761123,3048.055133,2793.671992
192.168.0.40,43529,192.168.1.30,80,28,8535,14,1119,14,7416,142.099901,1.666925,5370.367593,35591.28335
192.168.0.40,43530,192.168.1.30,80,12,1306,6,681,6,625,145.210418,1.501624,3628.072007,3329.728347
192.168.0.40,43532,192.168.1.30,21,68,5069,38,2395,30,2674,152.082076,18.924755,1012.430544,1130.371305
192.168.0.40,43540,192.168.1.30,21,44,3431,25,1590,19,1841,186.519549,10.813768,1176.278241,1361.967447
192.168.0.40,43546,192.168.1.30,21,66,4963,37,2376,29,2587,255.118743,16.665177,1140.581945,1241.870998
192.168.0.40,43555,192.168.1.30,21,48,3710,27,1736,21,1974,268.101355,11.567847,1200.569129,1365.163284
192.168.0.40,43570,192.168.1.30,23,1131,69869,730,43883,401,25986,321.914607,82.784077,4240.718901,2511.20756
192.168.0.40,43571,192.168.1.30,23,648,42025,406,24443,242,17582,332.097169,92.016231,2125.103342,1528.599884
192.168.0.40,43581,192.168.1.30,80,36,17702,16,1248,20,16454,365.527707,2.842425,3512.493733,46309.75312
192.168.0.40,43583,192.168.1.30,80,23,6652,11,963,12,5689,369.728178,1.55655,4949.407343,29239.0222
192.168.0.40,43584,192.168.1.30,80,12,1286,6,671,6,615,372.709009,1.566477,3426.79784,3140.80577
192.168.0.40,43588,192.168.1.30,80,26,8744,12,1017,14,7727,395.643861,1.526055,5331.393692,40507.05905
192.168.0.40,43589,192.168.1.30,80,15,1460,8,782,7,678,398.674566,1.599285,3911.748062,3391.515584
192.168.0.40,43590,192.168.1.30,25,30,10140,15,8928,15,1212,399.944658,3.978783,17951.21775,2436.926065
192.168.0.40,43591,192.168.1.30,80,18,8276,8,797,10,7479,411.656362,1.670114,3817.703462,35825.09936
192.168.0.40,43592,192.168.1.30,80,17,1556,9,827,8,729,414.745815,1.48722,4448.56847,3921.410417
192.168.0.40,43593,192.168.1.30,80,12,1274,6,665,6,609,417.616231,1.610988,3302.321308,3024.231093
192.168.0.40,43594,192.168.1.30,80,16,1500,8,772,8,728,420.626898,1.677903,3680.784884,3470.999217
192.168.0.40,43595,192.168.1.30,80,15,1442,8,773,7,669,423.727278,1.556246,3973.664832,3439.044984
192.168.0.40,43596,192.168.1.30,80,14,1384,7,718,7,666,426.688162,1.600556,3588.752908,3328.843227
192.168.0.40,43597,192.168.1.30,80,15,4571,7,714,8,3857,429.740311,1.715587,3329.472653,17985.6807
192.168.0.40,43599,192.168.1.30,80,11,1214,6,665,5,549,432.869746,1.515872,3509.531148,2897.342256
192.168.0.40,43600,192.168.1.30,23,140,17178,77,4703,63,12475,441.959014,41.184818,913.5405187,2423.223043
192.168.0.40,43602,192.168.1.30,21,58,4327,31,1984,27,2343,449.14192,15.733358,1008.811978,1191.354064
192.168.0.40,43606,192.168.1.30,80,26,17122,10,908,16,16214,456.413547,1.498737,4846.747628,86547.5397
192.168.0.40,43608,192.168.1.30,80,17,6310,8,801,9,5509,459.344651,1.489132,4303.177959,29595.76451
192.168.0.40,43610,192.168.1.30,80,18,1628,9,833,9,795,462.254699,2.060933,3233.486969,3085.980961
192.168.0.40,43612,192.168.1.30,23,1058,65372,683,41063,375,24309,467.083711,77.023739,4264.970829,2524.831987
192.168.0.40,43613,192.168.1.30,80,18,8288,8,801,10,7487,480.736855,1.504516,4259.177038,39810.80959
192.168.0.40,43614,192.168.1.30,80,18,1634,9,836,9,798,484.498249,1.622874,4121.083954,3933.761956
192.168.0.40,43617,192.168.1.30,80,28,8852,14,1133,14,7719,497.539915,2.063086,4393.418403,29931.85936
192.168.0.40,43618,192.168.1.30,80,11,1214,6,665,5,549,501.060338,1.580484,3366.057486,2778.895579
192.168.0.40,43619,192.168.1.30,80,12,1274,6,665,6,609,503.990964,1.559083,3412.262208,3124.913812
192.168.0.40,43620,192.168.1.30,80,11,1212,6,664,5,548,506.881436,1.482302,3583.615215,2957.561954
192.168.0.40,43621,192.168.1.30,80,15,1442,8,773,7,669,509.702057,1.510977,4092.71617,3542.079065
192.168.0.40,43622,192.168.1.30,80,17,1552,9,826,8,726,512.644141,1.548946,4266.126773,3749.646534
192.168.0.40,43623,192.168.1.30,80,15,4571,7,714,8,3857,515.633528,1.42825,3999.299842,21604.06091
192.168.0.40,43624,192.168.1.30,80,11,1214,6,665,5,549,518.483486,1.530552,3475.870144,2869.552946
192.168.0.40,43625,192.168.1.30,23,184,18442,110,6683,74,11759,532.084162,78.919625,677.4487334,1191.997554
192.168.1.30,1754,192.168.0.20,23,297,40072,169,10224,128,29848,30.226767,86.683725,943.5681265,2754.657809
192.168.1.30,1755,192.168.0.20,21,59,4323,31,1972,28,2351,33.111169,13.722289,1149.662421,1370.616812
192.168.1.30,1756,192.168.0.40,113,2,120,1,60,1,60,35.809119,0.000544,0,0
192.168.1.30,1761,192.168.0.40,113,2,120,1,60,1,60,37.756287,0.000526,0,0
192.168.1.30,1769,192.168.0.20,23,424,37430,244,14728,180,22702,44.024886,60.6385,1943.055979,2995.060894
192.168.1.30,1772,192.168.0.20,79,10,964,5,300,5,664,54.160276,3.170442,756.9922427,1675.476164
192.168.1.30,1778,192.168.0.20,25,28,5004,14,3818,14,1186,60.753181,2.384502,12809.38326,3979.027906
192.168.1.30,1783,192.168.0.20,25,31,9093,15,7787,16,1306,61.863638,3.033473,20536.19729,3444.237018
192.168.1.30,1784,192.168.0.40,80,9,744,5,346,4,398,64.021765,0.011047,250565.7645,288223.047
192.168.1.30,20,192.168.0.40,43505,8,520,5,340,3,180,74.482086,0.005209,522173.1618,276444.6151
192.168.1.30,20,192.168.0.40,43506,40,40950,31,40410,9,540,75.799644,0.179562,1800380.927,24058.54245
192.168.1.30,20,192.168.0.40,43508,11,3199,7,2959,4,240,77.39121,0.064765,365506.0604,29645.64194
192.168.1.30,20,192.168.0.40,43509,41,42723,32,42183,9,540,78.839031,0.21322,1582703.311,20260.76353
192.168.1.30,20,192.168.0.40,43510,8,520,5,340,3,180,80.342226,0.024167,112550.1717,59585.38503
192.168.1.30,1787,192.168.0.20,21,42,3067,23,1456,19,1611,93.433161,12.510256,931.0760707,1030.194746
192.168.1.30,1788,192.168.0.40,80,13,4655,7,714,6,3941,94.306112,1.540967,3706.763351,20459.88006
192.168.1.30,1789,192.168.0.40,80,13,4859,7,738,6,4121,97.601162,1.828335,3229.167521,18031.70644
192.168.1.30,1790,192.168.0.40,113,2,120,1,60,1,60,100.137845,0.000547,0,0
192.168.1.30,1796,192.168.0.40,80,17,2302,9,843,8,1459,101.670169,2.014203,3348.222597,5794.847888
192.168.1.30,1804,192.168.0.40,80,34,26525,12,1038,22,25487,105.530091,2.671505,3108.360269,76322.52232
192.168.1.30,1806,192.168.0.40,80,17,2298,9,839,8,1459,112.350474,1.936497,3466.052362,6027.378302
192.168.1.30,1807,192.168.0.40,80,21,2530,11,951,10,1579,115.581765,2.078236,3660.796945,6078.231731
192.168.1.30,1808,192.168.0.40,80,17,1960,9,846,8,1114,119.112239,2.071797,3266.729318,4301.57974
192.168.1.30,1810,192.168.0.40,80,13,4859,7,738,6,4121,123.137276,1.92261,3070.825596,17147.52342
192.168.1.30,1811,192.168.0.20,79,12,989,6,360,6,629,125.118595,0.958654,3004.212156,5249.026239
192.168.1.30,1814,192.168.0.40,80,13,2070,7,731,6,1339,126.896479,1.819498,3214.073332,5887.338156
192.168.1.30,1816,192.168.0.40,80,44,27095,17,1308,27,25787,131.114551,3.596091,2909.826253,57366.73516
192.168.1.30,1818,192.168.0.40,80,22,3746,12,1000,10,2746,133.496233,3.091625,2587.635952,7105.648324
192.168.1.30,1820,192.168.0.20,79,12,759,6,361,6,398,133.531387,1.037107,2784.669277,3070.078594
192.168.1.30,1826,192.168.0.20,25,31,7919,16,6675,15,1244,135.929463,1.533774,34816.08112,6488.570024
192.168.1.30,1830,192.168.0.40,80,11,1956,6,677,5,1279,137.840398,1.842639,2939.262655,5552.905371
192.168.1.30,1832,192.168.0.20,25,307,288491,205,282027,102,6464,137.881795,3.995622,564672.0335,12942.1652
192.168.1.30,1833,192.168.0.40,80,12,3780,7,738,5,3042,137.983612,2.199424,2684.339172,11064.71513
192.168.1.30,1834,192.168.0.20,79,12,1170,6,360,6,810,140.661324,2.842528,1013.182632,2279.660922
192.168.1.30,1835,192.168.0.40,80,11,1956,6,677,5,1279,141.48712,1.730442,3129.836192,5912.940162
192.168.1.30,1836,192.168.0.40,80,11,1956,6,677,5,1279,141.500062,2.042082,2652.195162,5010.572543
192.168.1.30,1837,192.168.0.40,80,15,1842,8,788,7,1054,144.856838,2.06722,3049.5061,4078.907905
192.168.1.30,1838,192.168.0.40,80,11,1956,6,677,5,1279,144.858083,1.910537,2834.805084,5355.562337
192.168.1.30,1839,192.168.0.40,80,11,1614,6,680,5,934,148.270342,1.780888,3054.65588,4195.659693
192.168.1.30,1841,192.168.0.20,79,12,758,6,360,6,398,149.65241,1.079618,2667.61021,2949.191288
192.168.1.30,1844,192.168.0.40,80,12,3780,7,738,5,3042,151.622991,1.908941,3092.814288,12748.42963
192.168.1.30,1846,192.168.0.40,80,27,2872,14,1113,13,1759,154.863015,2.33411,3814.73024,6028.850397
192.168.1.30,1847,192.168.0.20,79,12,758,6,360,6,398,157.070136,3.786075,760.6822369,840.976473
192.168.1.30,1848,192.168.0.40,80,21,2530,11,951,10,1579,158.551436,1.977269,3847.731391,6388.609744
192.168.1.30,20,192.168.0.40,43534,8,499,5,319,3,180,158.802446,0.027162,93954.78978,53015.24188
192.168.1.30,1849,192.168.0.40,80,12,2925,7,734,5,2191,159.652442,1.759751,3336.835723,9960.500093
192.168.1.30,1850,192.168.0.20,21,71,5213,38,2425,33,2788,160.499445,17.376713,1116.436693,1283.556907
192.168.1.30,1851,192.168.0.40,80,11,1614,6,680,5,934,162.079677,1.87212,2905.796637,3991.197145
192.168.1.30,1852,192.168.0.40,80,12,3780,7,738,5,3042,162.75863,2.01081,2936.130216,12102.58553
192.168.1.30,1853,192.168.0.40,80,23,2644,12,1005,11,1639,166.006781,2.314695,3473.459786,5664.677204
192.168.1.30,1855,192.168.0.20,79,12,899,6,361,6,538,166.781155,1.365191,2115.454907,3152.67241
192.168.1.30,20,192.168.0.40,43536,8,511,5,331,3,180,166.817253,0.020346,130148.4321,70775.58242
192.168.1.30,20,192.168.0.40,43537,11,3199,7,2959,4,240,169.668961,0.067435,351034.3294,28471.86179
192.168.1.30,1857,192.168.0.40,80,15,2184,8,785,7,1399,169.756125,1.933518,3247.965625,5788.412624
192.168.1.30,1859,192.168.0.40,80,11,1614,6,680,5,934,173.056134,1.756171,3097.648236,4254.710959
192.168.1.30,1861,192.168.0.40,80,16,4008,9,846,7,3162,176.146182,1.964626,3444.930485,12875.73309
192.168.1.30,1864,192.168.0.40,80,19,2412,10,893,9,1519,179.39433,2.085147,3426.137342,5827.886475
192.168.1.30,1866,192.168.0.40,80,11,1956,6,677,5,1279,182.757928,1.76262,3072.698596,5804.994837
192.168.1.30,1867,192.168.0.20,23,144,8834,84,5109,60,3725,183.980008,21.865257,1869.266846,1362.892739
192.168.1.30,1868,192.168.0.40,80,11,1614,6,680,5,934,185.878114,1.751975,3105.067139,4264.90104
192.168.1.30,1869,192.168.0.40,80,12,3211,7,719,5,2492,186.499032,1.74881,3289.093727,11399.75183
192.168.1.30,1870,192.168.0.40,80,11,1256,6,667,5,589,189.567967,1.666439,3202.037398,2827.586248
192.168.1.30,20,192.168.0.40,43542,8,499,5,319,3,180,190.951713,0.017984,141903.9146,80071.17438
192.168.1.30,1873,192.168.0.40,80,15,1490,8,781,7,709,192.522809,1.685842,3706.159889,3364.49086
192.168.1.30,20,192.168.0.40,43544,8,796,5,616,3,180,195.127867,0.833423,5912.963765,1727.814087
192.168.1.30,1874,192.168.0.40,80,11,1263,6,674,5,589,195.383115,1.706434,3159.80577,2761.313945
192.168.1.30,1875,192.168.0.40,80,17,1607,9,838,8,769,198.278161,1.871813,3581.554354,3286.6531
192.168.1.30,1876,192.168.0.20,23,611,38330,378,22768,233,15562,199.440847,44.821667,4063.748901,2777.585225
192.168.1.30,1877,192.168.0.40,80,11,1259,6,670,5,589,201.435858,1.610621,3327.908925,2925.579637
192.168.1.30,1878,192.168.0.40,80,25,2055,13,1046,12,1009,204.418975,1.940506,4312.277313,4159.739779
192.168.1.30,1879,192.168.0.40,80,11,1257,6,668,5,589,207.771235,1.55649,3433.366099,3027.3243
192.168.1.30,1880,192.168.0.40,80,15,1490,8,781,7,709,210.593595,1.633957,3823.846038,3471.327581
192.168.1.30,1881,192.168.0.40,80,11,1256,6,667,5,589,213.454356,1.63506,3263.488802,2881.851431
192.168.1.30,1882,192.168.0.40,80,11,1258,6,669,5,589,216.39778,1.541194,3472.632258,3057.369805
192.168.1.30,1883,192.168.0.40,80,11,1263,6,674,5,589,219.127782,1.731454,3114.145683,2721.412177
192.168.1.30,1884,192.168.0.20,23,144,8834,84,5109,60,3725,221.853285,23.765047,1719.8367,1253.942397
192.168.1.30,1885,192.168.0.40,80,11,1261,6,672,5,589,222.140133,1.61966,3319.215144,2909.252559
192.168.1.30,1886,192.168.0.40,80,17,1601,9,832,8,769,225.008479,1.783427,3732.140424,3449.538445
192.168.1.30,1887,192.168.0.40,80,19,1717,10,888,9,829,228.057012,1.729654,4107.179817,3834.29287
192.168.1.30,1889,192.168.0.40,80,21,1831,11,942,10,889,231.22098,1.960396,3844.12129,3627.838457
192.168.1.30,1890,192.168.0.20,23,1590,105103,1023,61466,567,43637,231.414065,100.731714,4881.560935,3465.601707
192.168.1.30,1891,192.168.0.40,80,11,1262,6,673,5,589,234.568505,1.673279,3217.634357,2816.027692
192.168.1.30,1892,192.168.0.20,21,51,3704,28,1763,23,1941,234.81587,11.788334,1196.437088,1317.234479
192.168.1.30,1900,192.168.0.20,25,29,5048,14,3806,15,1242,251.695146,1.037157,29357.17543,9580.034652
192.168.1.30,20,192.168.0.40,43548,8,499,5,319,3,180,259.875019,0.008468,301369.863,170051.9603
192.168.1.30,1023,192.168.0.20,514,13,822,7,449,6,373,260.389538,2.011388,1785.831476,1483.552651
192.168.1.30,1906,192.168.0.20,23,144,8834,84,5109,60,3725,261.525598,22.358347,1828.042118,1332.835562
192.168.1.30,20,192.168.0.40,43550,8,796,5,616,3,180,262.639729,0.535476,9203.02684,2689.196154
192.168.1.30,1022,192.168.0.20,513,67,4086,37,2249,30,1837,263.519107,13.859225,1298.196688,1060.376753
192.168.1.30,20,192.168.0.40,43552,8,516,5,336,3,180,265.913838,0.010924,246063.7129,131819.8462
192.168.1.30,20,192.168.0.40,43554,44,45552,34,44952,10,600,267.390555,0.176742,2034694.64,27158.23064
192.168.1.30,20,192.168.0.40,43558,8,796,5,616,3,180,270.359654,0.114924,42880.51234,12530.01984
192.168.1.30,20,192.168.0.40,43562,8,695,5,515,3,180,275.021868,0.052625,78289.78622,27363.42043
192.168.1.30,20,192.168.0.40,43563,41,42723,32,42183,9,540,276.482526,0.213178,1583015.133,20264.75527
192.168.1.30,20,192.168.0.40,43564,47,45720,36,45060,11,660,278.112727,0.21093,1709002.987,25032.00114
192.168.1.30,1022,192.168.0.20,514,15,933,8,500,7,433,279.147748,2.091052,1912.912735,1656.582428
192.168.1.30,1908,192.168.0.40,80,13,4655,7,714,6,3941,283.89981,1.771482,3224.418876,17797.52772
192.168.1.30,1909,192.168.0.40,80,19,5205,10,904,9,4301,286.878209,1.923281,3760.240963,17890.26149
192.168.1.30,1910,192.168.0.40,80,11,1956,6,677,5,1279,290.157242,1.775754,3049.972012,5762.059384
192.168.1.30,1912,192.168.0.40,80,32,26407,11,980,21,25427,293.155989,2.875325,2726.648292,70745.394
192.168.1.30,1913,192.168.0.40,80,23,2644,12,1005,11,1639,297.440143,2.259762,3557.896805,5802.380959
192.168.1.30,1914,192.168.0.20,23,662,48325,411,24729,251,23596,299.795025,40.289616,4910.247842,4685.276722
192.168.1.30,1915,192.168.0.40,80,11,1956,6,677,5,1279,301.186787,1.766688,3065.623359,5791.628177
192.168.1.30,1916,192.168.0.40,80,23,2302,12,1008,11,1294,304.193293,2.110883,3820.202257,4904.108849
192.168.1.30,1917,192.168.0.20,113,2,120,1,60,1,60,304.35676,0.001211,0,0
192.168.1.30,1922,192.168.0.40,80,13,4859,7,738,6,4121,307.749408,1.909787,3091.444229,17262.65809
192.168.1.30,1923,192.168.0.40,80,19,2416,10,897,9,1519,311.008856,1.789136,4010.874523,6792.10524
192.168.1.30,1924,192.168.0.40,80,32,26407,11,980,21,25427,314.260262,2.630209,2980.75172,77338.34079
192.168.1.30,1925,192.168.0.40,80,15,2184,8,785,7,1399,318.248582,1.870712,3357.010593,5982.748814
192.168.1.30,1926,192.168.0.40,80,23,2644,12,1005,11,1639,321.521824,1.98476,4050.867611,6606.340313
192.168.1.30,1927,192.168.0.40,80,27,2530,14,1116,13,1414,324.840672,2.324549,3840.745022,4866.320306
192.168.1.30,1931,192.168.0.40,80,13,3944,7,645,6,3299,342.797009,1.94952,2646.805367,13537.69133
192.168.1.30,1932,192.168.0.20,21,62,4672,34,2213,28,2459,343.758177,12.726873,1391.072261,1545.705689
192.168.1.30,1933,192.168.0.20,79,12,840,6,360,6,480,343.912201,2.050098,1404.810892,1873.081189
192.168.1.30,1934,192.168.0.40,80,11,1868,6,589,5,1279,346.112151,1.769453,2662.969856,5782.578006
192.168.1.30,1936,192.168.0.40,80,11,1868,6,589,5,1279,349.450318,1.846951,2551.231733,5539.941233
192.168.1.30,1939,192.168.0.20,79,12,807,6,360,6,447,352.207019,1.49983,1920.217625,2384.270217
192.168.1.30,1941,192.168.0.40,80,11,1868,6,589,5,1279,352.705084,1.72732,2727.925341,5923.627353
192.168.1.30,1944,192.168.0.40,80,11,1526,6,592,5,934,355.841554,1.795547,2637.63633,4161.405967
192.168.1.30,1945,192.168.0.40,80,11,1868,6,589,5,1279,359.298717,1.787943,2635.430772,5722.777516
192.168.1.30,1946,192.168.0.20,79,10,720,5,300,5,420,360.81596,1.205341,1991.137778,2787.592889
192.168.1.30,1947,192.168.0.40,80,13,1982,7,643,6,1339,362.53895,1.849327,2781.552424,5792.377443
192.168.1.30,1949,192.168.0.40,80,11,1868,6,589,5,1279,365.539794,1.788636,2634.409684,5720.560248
192.168.1.30,1951,192.168.0.40,79,11,780,6,360,5,420,368.338021,0.109378,26330.70636,30719.15742
192.168.1.30,1952,192.168.0.40,80,11,1526,6,592,5,934,368.82602,1.70534,2777.158807,4381.530956
192.168.1.30,1953,192.168.0.40,80,15,5842,8,704,7,5138,370.471827,1.860983,3026.357576,22087.25174
192.168.1.30,1954,192.168.0.40,80,12,3692,7,650,5,3042,373.457375,1.705834,3048.362267,14266.33541
192.168.1.30,1956,192.168.0.40,79,11,747,6,360,5,387,374.671356,0.110499,26063.58429,28018.35311
192.168.1.30,1957,192.168.0.40,80,11,1868,6,589,5,1279,376.393124,1.72512,2731.404192,5931.181599
192.168.1.30,1958,192.168.0.40,80,33,21796,12,943,21,20853,379.374145,2.778489,2715.144814,60041.26703
192.168.1.30,1959,192.168.0.20,23,360,28648,214,12903,146,15745,380.061323,48.330675,2135.786434,2606.212307
192.168.1.30,1961,192.168.0.40,79,10,963,5,300,5,663,380.672622,0.096723,24813.12614,54837.00878
192.168.1.30,1962,192.168.0.40,80,20,12485,9,772,11,11713,383.426412,2.194714,2814.034084,42695.31246
192.168.1.30,1963,192.168.0.40,80,11,1868,6,589,5,1279,386.9479,1.867579,2523.052572,5478.750832
192.168.1.30,1964,192.168.0.40,80,23,2214,12,920,11,1294,390.089443,1.994269,3690.575344,5190.874451
192.168.1.30,1965,192.168.0.40,80,11,1868,6,589,5,1279,393.329555,1.794721,2625.47772,5701.164694
192.168.1.30,1966,192.168.0.40,80,11,1526,6,592,5,934,396.436624,1.704081,2779.210613,4384.768095
192.168.1.30,1967,192.168.0.20,23,592,37191,366,22048,226,15143,399.672849,53.542475,3294.281783,2262.577514
192.168.1.30,1968,192.168.0.40,113,2,120,1,60,1,60,400.722228,0.000512,0,0
192.168.1.30,1976,192.168.0.20,25,27,2639,12,1398,15,1241,403.732787,2.127784,5256.172619,4665.887139
192.168.1.30,1978,192.168.0.20,23,185,14658,110,6684,75,7974,419.60459,36.115566,1480.580423,1766.329787
192.168.1.30,1982,192.168.0.40,80,15,5896,8,700,7,5196,436.169547,1.770614,3162.744675,23476.6019
192.168.1.30,1983,192.168.0.40,80,13,4655,7,714,6,3941,437.18639,1.703107,3353.870309,18512.04886
192.168.1.30,1984,192.168.0.20,21,51,3661,27,1702,24,1959,437.343886,10.841619,1255.900987,1445.54056
192.168.1.30,1985,192.168.0.40,80,16,3924,9,762,7,3162,439.486704,1.851849,3291.845069,13659.86104
192.168.1.30,1986,192.168.0.40,80,17,5087,9,846,8,4241,440.096307,2.000649,3382.902248,16958.49697
192.168.1.30,1988,192.168.0.40,80,11,1868,6,589,5,1279,442.834511,1.725914,2730.14762,5928.452982
192.168.1.30,1989,192.168.0.40,80,11,1956,6,677,5,1279,443.57703,2.176644,2488.234181,4700.814649
192.168.1.30,1991,192.168.0.40,80,29,12844,14,1050,15,11794,446.114628,2.214006,3794.027658,42615.964
192.168.1.30,1993,192.168.0.40,80,32,26407,11,980,21,25427,447.267182,3.15343,2486.181713,64506.26778
192.168.1.30,1994,192.168.0.40,80,23,10660,11,884,12,9776,450.137122,2.045915,3456.644093,38226.41703
192.168.1.30,1995,192.168.0.40,80,25,2754,13,1055,12,1699,452.141318,2.083502,4050.872041,6523.631847
192.168.1.30,1996,192.168.0.40,80,13,1982,7,643,6,1339,453.697047,1.864123,2759.474563,5746.401927
192.168.1.30,20,192.168.0.40,43605,8,783,5,603,3,180,455.040983,1.225085,3937.685956,1175.428644
192.168.1.30,1997,192.168.0.40,80,15,2184,8,785,7,1399,455.84101,1.823595,3443.747104,6137.327641
192.168.1.30,1998,192.168.0.40,80,11,1526,6,592,5,934,456.753035,1.93847,2443.163939,3854.586349
192.168.1.30,20,192.168.0.40,43607,8,796,5,616,3,180,459.06276,0.136425,36122.41158,10555.25014
192.168.1.30,1999,192.168.0.40,80,11,1614,6,680,5,934,459.377788,1.737388,3131.137086,4300.70888
192.168.1.30,2000,192.168.0.40,80,11,1868,6,589,5,1279,460.01651,1.878992,2507.727548,5445.472892
192.168.1.30,20,192.168.0.40,43609,8,695,5,515,3,180,461.877108,0.130687,31525.70646,11018.69352
192.168.1.30,2002,192.168.0.40,80,25,5547,13,1066,12,4481,462.685325,2.139062,3986.794212,16758.74753
192.168.1.30,2003,192.168.0.40,80,15,1758,8,704,7,1054,463.352462,2.000853,2814.799488,4214.202643
192.168.1.30,20,192.168.0.40,43611,11,3199,7,2959,4,240,463.384842,0.088208,268365.6811,21766.73318
192.168.1.30,2004,192.168.0.40,80,11,1956,6,677,5,1279,466.508108,1.832065,2956.22699,5584.954682
192.168.1.30,2005,192.168.0.40,80,12,3504,7,643,5,2861,467.040505,1.810353,2841.434792,12642.83816
192.168.1.30,2006,192.168.0.40,80,34,26521,12,1034,22,25487,469.59905,3.635208,2275.523161,56089.22516
192.168.1.30,2007,192.168.0.40,80,12,3692,7,650,5,3042,470.256366,2.016669,2578.509413,12067.42405
192.168.1.30,2009,192.168.0.40,80,11,1868,6,589,5,1279,473.585265,1.727486,2727.663205,5923.058132
192.168.1.30,2010,192.168.0.40,80,11,1956,6,677,5,1279,474.573923,1.839342,2944.531251,5562.858892
192.168.1.30,2011,192.168.0.40,80,39,34429,13,1011,26,33418,476.707874,3.065411,2638.471644,87213.10128
192.168.1.30,2012,192.168.0.40,80,17,2302,9,843,8,1459,477.729311,2.100135,3211.222136,5557.737955
192.168.1.30,2014,192.168.0.40,80,11,1614,6,680,5,934,481.592658,1.740342,3125.822396,4293.408997
192.168.1.30,2016,192.168.0.20,23,342,22494,203,12268,139,10226,483.437505,42.30346,2319.999357,1933.83709
192.168.1.30,2017,192.168.0.40,80,11,1868,6,589,5,1279,483.472049,1.928925,2442.811411,5304.508988
192.168.1.30,2018,192.168.0.40,80,11,1526,6,592,5,934,486.676301,1.672199,2832.198799,4468.3677
192.168.1.30,2019,192.168.0.40,80,12,3692,7,650,5,3042,489.915274,1.861898,2792.849018,13070.5334
192.168.1.30,2020,192.168.0.20,23,7,429,4,240,3,189,490.881886,5.168107,371.509336,292.5636021
192.168.1.30,2021,192.168.0.20,22,2,120,1,60,1,60,490.922369,0.001414,0,0
192.168.1.30,2022,192.168.0.20,21,7,475,4,240,3,235,490.926978,4.296852,446.8387554,437.5296147
192.168.1.30,2023,192.168.0.20,79,7,420,4,240,3,180,490.940913,3.624316,529.7551317,397.3163488
192.168.1.30,2024,192.168.0.20,80,2,120,1,60,1,60,490.956171,0.00131,0,0
192.168.1.30,2025,192.168.0.20,111,7,420,4,240,3,180,490.971173,0.052836,36338.85987,27254.1449
192.168.1.30,2026,192.168.0.20,110,2,120,1,60,1,60,490.987132,0.001427,0,0
192.168.1.30,2028,192.168.0.20,109,2,120,1,60,1,60,490.995107,0.001228,0,0
192.168.1.30,2029,192.168.0.20,515,2,120,1,60,1,60,491.010422,0.001253,0,0
192.168.1.30,2030,192.168.0.20,514,7,420,4,240,3,180,491.017065,5.496897,349.287971,261.9659783
192.168.1.30,2031,192.168.0.20,513,7,444,4,240,3,204,491.034865,5.200422,369.2008072,313.8206861
192.168.1.30,2032,192.168.0.20,512,7,420,4,240,3,180,491.05477,5.48556,350.009844,262.507383
192.168.1.30,2033,192.168.0.20,2049,2,120,1,60,1,60,491.080305,0.001333,0,0
192.168.1.30,2034,192.168.0.20,3000,2,120,1,60,1,60,491.099222,0.001267,0,0
192.168.1.30,2035,192.168.0.20,6000,2,120,1,60,1,60,491.114295,0.001207,0,0
192.168.1.30,2037,192.168.0.40,23,7,429,4,240,3,189,492.234753,0.050944,37688.44221,29679.64824
192.168.1.30,2038,192.168.0.40,22,2,120,1,60,1,60,492.263936,0.000579,0,0
192.168.1.30,2039,192.168.0.40,21,7,474,4,240,3,234,492.267717,0.089005,21571.82181,21032.52626
192.168.1.30,2040,192.168.0.40,79,7,420,4,240,3,180,492.287422,0.036571,52500.61524,39375.46143
192.168.1.30,2041,192.168.0.40,80,7,420,4,240,3,180,492.309263,0.032879,58395.93662,43796.95246
192.168.1.30,2042,192.168.0.40,111,7,420,4,240,3,180,492.387682,0.014329,133993.9982,100495.4986
192.168.1.30,2043,192.168.0.40,110,2,120,1,60,1,60,492.420726,0.000487,0,0
192.168.1.30,2044,192.168.0.40,109,2,120,1,60,1,60,492.42609,0.000483,0,0
192.168.1.30,2045,192.168.0.40,515,2,120,1,60,1,60,492.44897,0.00051,0,0
192.168.1.30,2046,192.168.0.40,514,7,420,4,240,3,180,492.455126,0.036346,52825.62043,39619.21532
192.168.1.30,2047,192.168.0.40,513,7,444,4,240,3,204,492.528216,0.03396,56537.10247,48056.5371
192.168.1.30,2048,192.168.0.40,512,7,420,4,240,3,180,492.557299,0.04923,39000.60938,29250.45704
192.168.1.30,2052,192.168.0.40,2049,7,420,4,240,3,180,492.60799,0.014563,131840.9668,98880.72513
192.168.1.30,1029,192.168.0.40,3000,2,120,1,60,1,60,492.652159,0.003416,0,0
192.168.1.30,1030,192.168.0.40,6000,7,420,4,240,3,180,492.670303,0.021597,88901.23628,66675.92721
192.168.1.30,1031,192.168.0.40,80,11,1868,6,589,5,1279,493.137147,1.721229,2737.578788,5944.589593
192.168.1.30,1032,192.168.0.40,80,40,34483,13,1005,27,33478,496.167339,3.841019,2093.19454,69727.33017
192.168.1.30,1033,192.168.0.40,80,21,13298,9,764,12,12534,497.064476,2.015756,3032.113014,49744.11586
192.168.1.30,1034,192.168.0.40,80,12,3692,7,650,5,3042,500.902296,1.79766,2892.649333,13537.59888
192.168.1.30,1035,192.168.0.40,80,15,2096,8,697,7,1399,501.664778,1.815618,3071.130601,6164.292269
192.168.1.30,1036,192.168.0.40,80,13,1982,7,643,6,1339,504.107829,1.712452,3003.879817,6255.357814
192.168.1.30,1037,192.168.0.40,80,11,1526,6,592,5,934,504.709933,1.793227,2641.048791,4166.789815
192.168.1.30,1038,192.168.0.40,80,11,1868,6,589,5,1279,507.265575,1.685234,2796.050875,6071.560389
192.168.1.30,1039,192.168.0.40,80,11,1526,6,592,5,934,510.342355,1.776617,2665.740562,4205.746089
192.168.1.30,1040,192.168.0.40,80,11,1868,6,589,5,1279,513.452491,1.824733,2582.295602,5607.395712
192.168.1.30,1041,192.168.0.40,80,11,1526,6,592,5,934,516.575104,1.686984,2807.376952,4429.206205
192.168.1.30,1042,192.168.0.20,23,427,31163,261,15744,166,15419,529.625458,37.944887,3319.340495,3250.820064
192.168.1.30,1048,192.168.0.20,25,27,4318,13,3132,14,1186,552.041959,0.988558,25346.00904,9597.818236
192.168.1.30,1050,192.168.0.20,79,10,720,5,300,5,420,582.03196,0.933034,2572.25353,3601.154942
